SO ./texture/xpm/wolfestein/brick_wall.xpm
  EA ./texture/xpm/wolfestein/steel_wall.xpm

                   C 0, 55, 55
      WE ./texture/xpm/wolfestein/grey_wall.xpm
 F 160,160,160
 
   NO ./texture/xpm/wolfestein/blue_wall.xpm



 


        111111111111111111111    
        100000000011            1
        101100000111            1
        100100000001            1
11111111101100000111            1
100000000011000001111111111111111
11110111111111011100000010001     
11110111111111011101010010001    
11000000110101011100000010000  
10000000000000001100N00000011    
10000000000000001101010010001    
1100000111010101111101111000111  
11110111 1110101 101111010001    
11111111 1111111 111111111111





